pos,ref,alt,Chinese,PROVEN,SIFT,PolyPhen-2,6F PCA linear CLF
992,D,Y,1,1,1,1,1
220,D,N,0,0,1,1,0
893,G,R,0,1,1,1,1
154,M,V,1,0,1,0,0
802,L,P,1,1,1,1,1
371,L,P,1,1,1,1,0
613,T,M,1,1,1,1,0
742,D,Y,0,1,1,1,0
955,A,D,1,1,1,1,1
888,L,P,0,1,1,0,1
804,T,I,1,1,1,1,1
333,C,F,1,1,1,1,1
818,E,K,0,1,1,1,1
801,D,V,1,1,1,1,1
358,G,C,1,1,1,1,0
715,L,P,1,1,1,1,0
808,P,L,1,1,1,1,1
773,N,S,1,1,1,1,1
140,Q,L,1,1,1,1,1
805,D,H,1,1,1,1,1
755,G,C,1,1,1,1,0
801,D,E,1,0,0,1,1
370,T,N,1,1,1,1,0
923,D,N,1,1,1,1,1
9,D,G,0,1,1,1,1
969,R,C,0,0,0,0,0
976,S,N,1,1,1,1,1
115,P,R,1,0,0,1,0
72,P,T,1,0,0,0,1
988,I,V,0,1,0,1,0
903,V,L,1,1,1,1,1
883,R,H,1,1,1,0,1
639,N,D,1,1,0,1,1
9,D,E,0,1,1,1,1
468,A,V,1,1,1,1,1
19,R,H,1,1,0,1,1
659,D,H,1,1,0,0,1
885,V,I,1,1,1,1,1
503,R,C,1,0,0,0,1
666,E,K,1,1,0,1,1
649,D,V,1,0,0,1,1
343,R,W,1,0,0,0,1
428,D,G,1,0,0,1,1
203,V,L,0,1,0,0,1
507,R,H,1,0,0,0,1
1004,G,A,1,0,0,1,1
708,G,C,0,0,0,0,1
871,G,S,1,1,1,1,1
872,N,K,1,1,1,1,1
340,R,C,1,0,0,0,1
238,N,S,1,0,0,0,1
986,F,C,1,1,0,0,1
438,A,T,1,1,1,1,1
572,N,D,1,1,1,1,1
831,T,M,1,1,1,1,1
444,S,T,0,1,1,1,1
413,H,R,0,1,1,1,1
390,A,S,0,1,0,1,1
184,K,R,1,1,0,1,1
221,C,Y,1,1,1,1,1
84,R,Q,0,1,0,1,1
7,D,E,1,1,1,1,1
724,M,V,0,0,0,0,1
521,D,E,1,0,0,1,1
941,N,K,1,0,0,1,0
576,V,M,0,1,0,0,1
6,D,E,0,1,1,1,1
817,A,T,1,0,0,0,1
701,I,T,0,0,0,0,1
80,V,I,1,1,0,1,1
717,K,N,0,0,0,0,1
230,R,P,1,0,0,0,1
20,R,G,1,1,1,1,1
691,I,V,0,1,0,0,1
977,W,G,0,0,0,0,0
463,R,H,1,0,0,1,1
698,Q,H,1,1,0,1,1
269,V,M,0,1,1,1,1
558,G,S,1,0,0,1,1
522,E,K,1,1,1,1,1
343,R,Q,1,1,0,0,1
807,V,I,0,1,1,1,1
1012,Y,S,1,0,0,0,1
43,R,Q,1,1,1,1,1
2,G,A,0,1,1,1,1